1111111111111
1001000000001
1P00011111001
100011E000001
1111111111111