1111111111111
100100000C001
1P00011111001
100011E000001
1111111111111