1111111111111
10C10000000E1
10P0011C11101
100011110C001
1111111111111