1111111111111
1C010001000E1
100110110C001
1P01010100001
1000000C00001
1111111111111