1111111111111111111111111111111111111111111111111
1E00000000000000000000000000000000000000000000001
1010001000100000101001000000010100000000000000001
101101100010101000100100000001C100000000000100001
1P10101000000000000000000000000000000000000000001
101000101111000000000000011111100000000C000100001
10000000100100010000C0000000010000000000000000001
1000000011110000000000000000100000000000000000001
1000000010010000000000C00001000000000000111C00001
1000000010010100100000000010000000000000001000001
10000000000C0100101001000111111000010010010000001
1000010000000100101001000000000000010010100000001
1000000000000100100000000000000000011110111000001
100000000000011110111100000C000000000010000010001
10100101001000000010010000000000000000100C0000001
1010010010101010001111000000000000000000000010001
1000000000000000C01100000000000000100100000000001
1000000000C00000001010011110000000000001C00000001
101001010000000000100101001001010000000C000010001
1010010010101010000000010010010100000100000000001
1000000000000000000000011110000000000000000000001
1111111111111111111111111111111111111111111111111