111111111111111111111111111111111111111111111111111
100100000000000000000C0C0C0C0000000000000000000CCC1
10000111110111110100010101010000000000000000000CEC1
10000100000100010110110101010000000000000000000CCC1
100001000001111101010101010100000000000000000000001
111001111101000101010101010100000000000000000000001
100100000000000000000000000000000000000000000000001
1000000000C0000000000000011100111000000000000000001
100000000000000000000000010011001000000000000000001
10000000000000000000000001000000100000000C000000001
100000000000000000000000001000010000000000000000001
100100000000000000000000000100100000000000000000001
100000000000000000000000000011000000000000000000001
100000000000000000000000000000000000000000000000001
10000000000000000P000000000000000000000000000000001
100000000000000000000000000000000000000000000000001
100100000000000000000000000000000000000000000000001
100000000000000000000000000000000000000000000000001
100000000000000000000000000000000000000000000000001
111111111111111111111111111111111111111111111111111