1111111111111111111111111111111111
1E0000000000000C00000C006666660001
1010010100100000000101001000000011
1010010010101010001001000000010101
1P0000000C00C0666660000000000000C1
1111111111111111111111111111111111