1111111111111
100000C0000C1
1000111101001
1P0011E000001
1110111111111